
GLScene ver.1.3.0
28/12/2014
========================================
Renamed units:

ApplicationFileIO->GLApplicationFileIO
AsyncTimer->GLAsyncTymer
AVIRecorder->GLAVIRecorder
BaseClasses->GLBaseClasses
BumpMapping->GLBumpMapping
CurvesAndSurfaces->GLCurvesAndSurfaces
GeometryCoordinates->GLGeometryCoordinates
GeometryBB->GLGeometryBB
HightTileFile->GLHightTileFile
FRUniformEditor->FShaderUniformEditor
ImageUtils->GLImageUtils
MeshUtils->GLMeshUtils
Octree->GLOctree
PerlinNoise3D->GLPerlinNoise3D
PersistentClasses->GLPersistentClasses
PlugInIntf->GLPlugInIntf
PlugInManager->FPlugInManager
PluginManagerPropEditor->FPlugInManagerEditor
Polynomials->GLPolynomials
RGBE->GLSRGBE
SpacingPartitioning->GLSpacePartition
Spline->GLSpline
VectorTypes->GLVectorTypes
VectorLists->GLVectorLists
VectorGeometry->GLVectorGeometry
VerletClasses->GLVerletTypes
VerletHairClasses->GLVerletHairClasses

====================================
Refactoring classes:

TCollisionManager>>TGLCollisionManager
TJoystick>>>TGLJoystick
TScreenSaver>>>TGLScreenSaver
TAsyncTimer>>>TGLAsyncTimer
TApplicationFileIO>>TGLApplicationFileIO

===========================================


